11111111111111111
11111111111111110
11111111110000000
11111111100111001
11111100001110011
11111000010001111
11111111000011111
11110011000100100
11100011101110111
00110001110000101
11110000110000111
00001110001000101
11110001000100001
11110000010001001
00100111111000001
11100100100110011
11111000111110010
11111110000111111
11101001110011111
11111111100111111
